NO ./assets/siding0.xpm
SO ./assets/siding1.xpm
WE ./assets/siding2.xpm
EA ./assets/siding3.xpm

F 255,0,255


C 0,218,218

1111111111111111111111111111111
1000000000000000000000000000001
1000000000000000000000000000001
1000000000000000000000000000001
1000000000000000000000000000001
111111110000000E011111111111111
1111111111111110000000011111111
1000000000000000000000000000001
1111111111111111111111111111111
