NO ./assets/siding0.xpm
EA ./assets/siding3.xpm
WE ./assets/siding2.xpm
SO ./assets/siding1.xpm

C 200,200,200
F 100,100,100

11111
10001
10001
1E001
10001
11111
